111111111111111
120000004000011
100011111100011
100010000100011
100010550100011
100011111100011
100000000000011
111100000011111
100000000000011
100011111100011
100010550100013
100010000100011
100011111100011
100000004000011
311111111111113