111111111111111
100000000000031
101111441111101
101151441151101
101111111111101
101000000040101
101111411111101
101000000000101
101111111111101
101111411111001
101151111141101
101111411111101
100000000030001
102111111411111
111111111111111
